en bil : автомобиль
en bil : машина
en blyant : карандаш
en bok : книга
en dusj : душ
en flaske : бутылка
en hånd : рука
en jobb : работа
en klokke : часы
en koffert : чемодан
en mobil : мобильный телефон
en ost : сыр
en pc : компьютер
en penn : ручка
en pølse : сосиска
en sekk : рюкзак
en stige : лестница (стремянка)
en stol : стул
en sykkel : велосипед
en telefon : телефон
en trapp : лестница
en trikk : трамвай
en vekkerklokke : будильник
en veske : сумка
et bad : ванная
et bord : стол
et glass : стакан
et hjem : дом
et hjerte : сердце
et hode : голова
et hus : дом
et kamera : камера
et kontor : офис
et land : страна
et sykehus : больница
et tog : поезд